U...........
.P.T....O...
.........P..
.d....P.....
...P......D.
T.....U.....
....D....P..
..O.........
............
..P...T...P.
.U.......dO.
.........T..