............
U..G........
............
....P.......
............
...d....G...
............
..T.........
......U.....
............
P..G.....D..
XP..........